10, 10
1111111111
1211111111
1011111111
1000111111
1110011111
1111000111
1111110111
1110000111
1110111111
1113111111